{
  "name": "Sofle",
  "vendorProductId": 4231135879,
  "macros": [
    "",
    "",
    "",
    "",
    "",
    "",
    "",
    "",
    "",
    "",
    "",
    "",
    "",
    "",
    "",
    ""
  ],
  "layers": [
    [
      "KC_ESC",
      "KC_1",
      "KC_2",
      "KC_3",
      "KC_4",
      "KC_5",
      "KC_TAB",
      "KC_Q",
      "KC_W",
      "KC_E",
      "KC_R",
      "KC_T",
      "KC_GRV",
      "KC_A",
      "KC_S",
      "KC_D",
      "KC_F",
      "KC_G",
      "KC_LSFT",
      "KC_Z",
      "KC_X",
      "KC_C",
      "KC_V",
      "KC_B",
      "KC_LGUI",
      "KC_LALT",
      "KC_LCTL",
      "MO(2)",
      "KC_ENT",
      "TG(1)",
      "KC_BSPC",
      "KC_0",
      "KC_9",
      "KC_8",
      "KC_7",
      "KC_6",
      "KC_LBRC",
      "KC_P",
      "KC_O",
      "KC_I",
      "KC_U",
      "KC_Y",
      "KC_QUOT",
      "KC_SCLN",
      "KC_L",
      "KC_K",
      "KC_J",
      "KC_H",
      "KC_RSFT",
      "KC_SLSH",
      "KC_DOT",
      "KC_COMM",
      "KC_M",
      "KC_N",
      "KC_RGUI",
      "KC_RALT",
      "KC_RCTL",
      "MO(3)",
      "KC_SPC",
      "KC_MUTE"
    ],
    [
      "KC_TRNS",
      "KC_TRNS",
      "KC_TRNS",
      "KC_TRNS",
      "KC_TRNS",
      "KC_TRNS",
      "KC_TRNS",
      "KC_TRNS",
      "KC_TRNS",
      "KC_TRNS",
      "KC_TRNS",
      "KC_TRNS",
      "KC_TRNS",
      "KC_TRNS",
      "KC_TRNS",
      "KC_TRNS",
      "KC_TRNS",
      "KC_TRNS",
      "KC_TRNS",
      "KC_TRNS",
      "KC_TRNS",
      "KC_TRNS",
      "KC_TRNS",
      "KC_TRNS",
      "KC_TRNS",
      "KC_TRNS",
      "KC_TRNS",
      "KC_TRNS",
      "KC_SPC",
      "KC_TRNS",
      "KC_TRNS",
      "KC_TRNS",
      "KC_TRNS",
      "KC_TRNS",
      "KC_TRNS",
      "KC_TRNS",
      "KC_TRNS",
      "KC_TRNS",
      "KC_TRNS",
      "KC_TRNS",
      "KC_TRNS",
      "KC_TRNS",
      "KC_TRNS",
      "KC_TRNS",
      "KC_TRNS",
      "KC_TRNS",
      "KC_TRNS",
      "KC_TRNS",
      "KC_TRNS",
      "KC_TRNS",
      "KC_TRNS",
      "KC_TRNS",
      "KC_TRNS",
      "KC_TRNS",
      "KC_TRNS",
      "KC_TRNS",
      "KC_TRNS",
      "KC_TRNS",
      "KC_ENT",
      "KC_TRNS"
    ],
    [
      "KC_TRNS",
      "KC_F1",
      "KC_F2",
      "KC_F3",
      "KC_F4",
      "KC_F5",
      "KC_TRNS",
      "KC_TRNS",
      "KC_P7",
      "KC_P8",
      "KC_P9",
      "KC_TRNS",
      "KC_TRNS",
      "KC_TRNS",
      "KC_P4",
      "KC_P5",
      "KC_P6",
      "KC_TRNS",
      "KC_TRNS",
      "KC_TRNS",
      "KC_P1",
      "KC_P2",
      "KC_P3",
      "KC_TRNS",
      "KC_P0",
      "KC_TRNS",
      "KC_TRNS",
      "KC_TRNS",
      "KC_TRNS",
      "KC_TRNS",
      "KC_TRNS",
      "KC_TRNS",
      "KC_TRNS",
      "KC_MNXT",
      "KC_MPLY",
      "KC_MPRV",
      "KC_TRNS",
      "KC_TRNS",
      "KC_TRNS",
      "KC_TRNS",
      "KC_TRNS",
      "KC_TRNS",
      "KC_TRNS",
      "KC_TRNS",
      "KC_TRNS",
      "KC_TRNS",
      "KC_TRNS",
      "KC_TRNS",
      "KC_TRNS",
      "KC_TRNS",
      "KC_TRNS",
      "KC_TRNS",
      "KC_TRNS",
      "KC_TRNS",
      "KC_TRNS",
      "KC_TRNS",
      "KC_TRNS",
      "KC_TRNS",
      "KC_TRNS",
      "KC_TRNS"
    ],
    [
      "KC_TRNS",
      "KC_TRNS",
      "KC_TRNS",
      "KC_TRNS",
      "KC_TRNS",
      "KC_TRNS",
      "KC_TRNS",
      "KC_INS",
      "KC_PSCR",
      "KC_APP",
      "KC_TRNS",
      "KC_TRNS",
      "KC_TRNS",
      "KC_LALT",
      "KC_LCTL",
      "KC_LSFT",
      "KC_TRNS",
      "KC_CAPS",
      "KC_TRNS",
      "KC_UNDO",
      "KC_CUT",
      "KC_COPY",
      "KC_PASTE",
      "KC_TRNS",
      "KC_TRNS",
      "KC_TRNS",
      "KC_TRNS",
      "KC_TRNS",
      "KC_TRNS",
      "KC_TRNS",
      "KC_TRNS",
      "KC_EQL",
      "KC_MINS",
      "KC_MNXT",
      "KC_MPLY",
      "KC_MPRV",
      "KC_BSLS",
      "KC_RBRC",
      "KC_LBRC",
      "KC_UP",
      "KC_DEL",
      "KC_PGUP",
      "KC_END",
      "KC_HOME",
      "KC_RGHT",
      "KC_DOWN",
      "KC_LEFT",
      "KC_PGDN",
      "KC_TRNS",
      "KC_TRNS",
      "KC_TRNS",
      "KC_TRNS",
      "KC_TRNS",
      "KC_TRNS",
      "KC_TRNS",
      "KC_TRNS",
      "KC_TRNS",
      "KC_TRNS",
      "KC_TRNS",
      "KC_TRNS"
    ]
  ]
}
